w w w w w w w w w w w w w w w
w . . m r . . . . . r m . . w
w . f f f . . . . . f f f . w
w . . . . . . . . . . . . . w
w . . . . . . . . . . . . . w
w . . . . . . . . . . . . . w
w . f f f . . . . . f f f . w
w . . m r . . . . . r m . . w
w w w w w w w w w w w w w w w